NO textures/walls/Wall2.xpm
SO textures/walls/Wall3.xpm
WE textures/walls/Wall4.xpm
EA textures/walls/Wall5.xpm

F 65,55,35
C 25,25,25

111111111111111111111111111111
1F0000000000000000000000000001
1111111D10001111111111111111D1
1F0000101000000001111111111101
1000000000111111000F000F111101
11111011111F000F00000000111001
10011D1111100F000F00F00111101
11000011111F000F000F000F111001
111NF1111111111111111111111101
111111F00000000000000000D00001
1F00000000011111111011111111D1
100000000001F000000001F0000001
101010101011000000000100000001
111111111111000000000100000001
           1F00000000100000001
           111111111D100000001
                   100000000F1
                   11111111111