NO textures/walls/Wall2.xpm
SO textures/walls/Wall3.xpm
WE textures/walls/Wall1.xpm
EA textures/walls/Wall5.xpm

F 65,55,35
C 25,25,25

112343212343212343212343212341
2F0000000000000000000000000002
1123423D30001234231234321243D3
2F0000301000000001234321111101
300000D000123431000F000F143102
41211032341F000F00000000212003
30013D1111200F000F00F00311104
12000041113F000F000F000F112003
111NF2112343212343212341324102
134321F00000000000000000D00001
2F00000000021234321011413113D3
100000000003F000000002F0000002
201040203041000000000300000004
343212343212000000000400000003
           3F00000000100000002
           432123413D300000001
                   200000000F2
                   12343212343