NO textures/walls/Wall2.xpm
SO textures/walls/Wall3.xpm
WE textures/walls/Wall4.xpm
EA textures/walls/Wall5.xpm

F 220,100,0
C 225,30,0

111111111111111111111111111111
1F0000000000000000000000000001
111111101000111111111111111101
1F0000101000000001111111111101
1000000000111111000F000F111101
11111011111F000F00000000111101
1001101111100F0000F00F00111101
 1100011111F000F000F000F111101
 11EF1111111111111111111111101
111111F00000000000000000000001
1F0000000001111111101111111101
100000000001F000000001F0000001
101010101011000000000100000001
111111111111000000000100000001
111111111111F00000000100000001
111111111111111111110100000001
1111111111111111111100000000F1
111111111111111111111111111111