NO textures/walls/Wall2.xpm
SO textures/walls/Wall3.xpm
WE textures/walls/Wall1.xpm
EA textures/walls/Wall5.xpm

F 65,55,35
C 25,25,25

142343214314214324214324213421
2F0000000000000000000000000004
1123123D30001231231231321243D3
2F0000301000000D01231321111101
300000D000123431000F000F123104
41211032311F000F00000000212003
30013D1111200F000F00F00311104
42000031113F000F000F000F112003
111NF2112313212313212321323102
134321F00000000000000000D00001
2F00000000021212123D31213113D3
400000000002F0000000F2F0000002
201030201041000000000100000004
343242343212000000000200000003
           1F00000000100000002
           412121213D300000004
                   400000000F2
                   12343214343