NO textures/walls/Wall2.xpm
SO textures/walls/Wall3.xpm
WE textures/walls/Wall4.xpm
EA textures/walls/Wall5.xpm

F 65,55,35
C 25,25,25

111111
100001
10N001
100001
111111