NO textures/walls/Wall2.xpm
SO textures/walls/Wall3.xpm
WE textures/walls/Wall4.xpm
EA textures/walls/Wall5.xpm

F 65,55,35
C 25,25,25

11111111
10100001
10N00101
10010001
11111111