NO textures/walls/wall1.xpm
SO textures/walls/wall2.xpm
WE textures/walls/wall3.xpm
EA textures/walls/wall4.xpm
F 90,90,90
C 135,206,235

1111111111
1000000001
1011111101
110N0000101
11010110101
11000000001
11111111111
