NO textures/north.xpm
SO textures/south.xpm
WE textures/west.xpm
EA textures/east.xpm
F 90,90,90
C 135,206,235

1111111111
1000000001
1011111101
10N0000101
1010110101
1000000001
1111111111
